
##########################################################
##########################################################
##########################################################
##############################################.......#####
#####%########################################......C#####
####...##########################################.########
####...##########################################.########
####...##########################################.########
####..............................................########
####..............................................########
###########...#####################...######.####.########
###########...#####################...######.####.########
###########...#####################...######.####.########
###########...######################§#######.####.########
###########...#####################...######.####.########
###########...#####################...######.####.########
######...............############.......####.####.########
######...............############..C.C..####.####.########
######...............#############.....#####.####...%#####
######...............#######################.#############
############§###############################.#############
############.###############################.#############
############.###########....#########........#############
############.###########.%..##############################
##########.....#########....##############################
##########.....##########..###############################
##########.end.##########..............###################
##########..%..######################..###################
#####################################..###################
#####################%....§.....C......###################
##########################################################
##########################################################
##########################################################
##########################################################