#############################################
#############################################
#############################################
#####.......#...................#.......#####
#####.......#...................#.......#####
####%....#..#######...#######...#...#...#####
#####....#..#..............##.......#...#####
#####.C..#..#..............##.......#...#####
##########..#...#...#...#..##########...#####
#####.......#...#...#...#.....#.....#...#####
#####.......#...#...#...#.....#.....#...#####
##########..#####...#...#..####..####...#####
#####.......#...#...#...#...........#...#####
#####.......#...#...#...#...........#...#####
##########..#...#########..##########...#####
#####....#......#.......#...........#...#####
#####....#......#.......#...........#...#####
#####....####...####...####...###############
#####....#..#...#......#...#............#####
#####....#..#...#......#...#............#####
#####....#..#...#...####...####..#...#..#####
#####.......#.................#..#...#..#####
#####.......#.................#..#...#..#####
#####...##..####....#...##########...########
#####....#..........#................#..#####
#####....#..........#................#..#####
#############...#...#############....#..#####
#####...........#.......#.......#.......#####
#####...........#.......#.......#.......#####
#####...#########...#####...#...#....########
#####...........#...........#...#.......#####
#####...........#...........#...#.......#####
#############################################
#############################################
#############################################