#####################################
#.......#...................#.......#
#.......#...................#.......#
#....#..#######...#######...#...#...#
#....#..#..............##.......#...#
#....#..#..............##.......#...#
######..#...#...#...#..##########...#
#.......#...#...#...#.....#.....#...#
#.......#...#...#...#.....#.....#...#
######..#####...#...#..####..####...#
#.......#...#...#...#...........#...#
#.......#...#...#...#...........#...#
######..#...#########..##########...#
#....#......#.......#...........#...#
#....#......#.......#...........#...#
#....####...####...####...###########
#....#..#...#......#...#............#
#....#..#...#......#...#............#
#....#..#...#...####...####..#...#..#
#.......#.................#..#...#..#
#.......#.................#..#...#..#
#...##..####....#...##########...####
#....#..........#................#..#
#....#..........#................#..#
#########...#...#############....#..#
#...........#.......#.......#.......#
#...........#.......#.......#.......#
#...#########...#####...#...#....####
#...........#...........#...#.......#
#...........#...........#...#.......#
#####################################