##########################################
##########################################
##########################################
##########################################
######...%...#...%...#...%...#...%...#####
######.......#.......#.......#.......#####
######.......#.......#.......#.......#####
######C......#......C#C......#......C#####
#########§#######§#######§#######§########
####%................................#####
##########################################
##########################################
##########################################
##########################################
##########################################