##############################
#                            #
#                            #
#                            #
#                            #
#                            #
#                            #
#                            #
#                            #
#                            #
#            %               #
#                            #
#                            #
#                            #
##############################