##############################
##############################
#............................#
#.........................@..#
#............................#
####..########################
#............................#
#......C.....C.....C.........#
#............................#
#########################..###
#..............#.............#
%..............§.............#
#..............#.............#
##############################
##############################